{
  "account_id": {
    "strategy": "high_as_mid",
    "top_categories": [
      "ID000558983",
      "ID000363102",
      "ID000622658",
      "ID000412421",
      "ID000768063",
      "ID000967839",
      "ID000686647",
      "ID000921190",
      "ID000309684",
      "ID000060721"
    ]
  }
}